2000000000
0000000001
1010100000
0000001000
0000100010
1000011100
1010001010
0000100000
0001000001
0000001301
