2100000000
0000001000
0000000000
0010000000
0000001000
0001000000
0000010000
0000000010
0000000300
0101000100
