2000000100
0000000000
0010000010
0000010010
0000000000
0000100000
1100000000
0000000000
0000001000
0000000130
