2000000000
1110001010
0000000010
0010010001
1000000000
1000001000
0000000000
0000101003
0010000010
0011010010
