2000100000
1000000000
0100100000
0000000100
0110000000
0000000000
0000000030
0001000001
0000000000
0000100000
