2000100100
0000010000
1000000100
0011100010
1110000001
0000010000
0000130000
0100000000
0000000100
0011000100
